01000001
01100101
01100101
00100101
00100101
00000101
10001101
11101001